{
  "active_level": 0,
  "levels": [
    {
      "id": 1,
      "width": 20,
      "height": 10,
      "max_hits": 3,
      "matrix": [
        "####################",
        "#                  #",
        "#   #####   #####  #",
        "#   #           #  #",
        "#   #   #####   #  #",
        "#       #   #      #",
        "#   #####   #####  #",
        "#                  #",
        "#                  #",
        "####################"
      ]
    },
    {
      "id": 2,
      "width": 20,
      "height": 10,
      "max_hits": 3,
      "matrix": [
        "####################",
        "#                  #",
        "#  ##############  #",
        "#  #            #  #",
        "#  #  ########  #  #",
        "#  #  #      #  #  #",
        "#  #  #  #####  #  #",
        "#     #            #",
        "#     #            #",
        "####################"
      ]
    },
    {
      "id": 3,
      "width": 20,
      "height": 10,
      "max_hits": 4,
      "matrix": [
        "####################",
        "#   #          #   #",
        "#   #   ####   #   #",
        "#   #   #  #   #   #",
        "#       ####       #",
        "#       ####       #",
        "#   #   #  #   #   #",
        "#   #   ####   #   #",
        "#   #          #   #",
        "####################"
      ]
    },
    {
      "id": 4,
      "width": 20,
      "height": 10,
      "max_hits": 4,
      "matrix": [
        "####################",
        "#                  #",
        "#  ####  ##  ####  #",
        "#  #  #  ##  #  #  #",
        "#  ####  ##  ####  #",
        "#                  #",
        "#  ####  ##  ####  #",
        "#  #  #  ##  #  #  #",
        "#  ####  ##  ####  #",
        "####################"
      ]
    },
    {
      "id": 5,
      "width": 20,
      "height": 10,
      "max_hits": 5,
      "matrix": [
        "####################",
        "#                  #",
        "# # # # # # # # #  #",
        "#                  #",
        "#  # # # # # # # # #",
        "#                  #",
        "# # # # # # # # #  #",
        "#                  #",
        "#                  #",
        "####################"
      ]
    },
    {
      "id": 6,
      "width": 20,
      "height": 10,
      "max_hits": 5,
      "matrix": [
        "####################",
        "#                  #",
        "#  ###        ###  #",
        "#  # #   ##   # #  #",
        "#  ###  ####  ###  #",
        "#       ####       #",
        "#  ###  ####  ###  #",
        "#  # #   ##   # #  #",
        "#  ###        ###  #",
        "####################"
      ]
    }
  ]
}
